7 4 7 4 7 4 7 4 7 4 7 4 7 4 7
2 0 1 0 2 0 2 0 2 0 2 0 1 0 1
7 3 7 3 7 4 7 4 7 4 7 4 7 3 7
1 0 2 0 2 0 2 0 2 0 2 0 2 0 1
7 3 7 4 7 4 7 4 7 4 7 4 7 3 7
1 0 2 0 1 0 2 0 2 0 2 0 2 0 1
7 4 7 3 7 3 7 4 7 4 7 4 7 4 7
1 0 1 0 1 0 1 0 1 0 2 0 1 0 1
7 3 7 3 7 3 7 3 7 3 7 3 7 3 7
1 0 1 0 1 0 1 0 1 0 1 0 1 0 1
7 3 7 3 7 3 7 3 7 3 7 3 7 3 7
1 0 1 0 1 0 1 0 1 0 1 0 2 0 1
7 3 7 4 7 3 7 3 7 3 7 3 7 3 7
1 0 1 0 2 0 2 0 1 0 1 0 1 0 1
7 3 7 3 7 4 7 4 7 3 7 3 7 4 7
1 0 2 0 2 0 2 0 2 0 1 0 2 9 1
7 4 7 4 7 4 7 4 7 4 7 4 7 3 7
